SO textures/32/south.png
WE textures/32/west.png
EA textures/32/east.png
NO textures/32/north.png

F 20,20,20
C 200,200,200

111111111111111111111111111
100000000000100000000000001
100000000000000000000000001
110000000000000000000000001
110000000000000000000000011
110000000000W00000000000011
110000000000000000000000001
100000000000000000000000001
100000000000000000000000001
100000000011100000000000001
111111111111111111111111111
